#define dilbert_width 80
#define dilbert_height 96
static unsigned char dilbert_bits[] = {
   0xfe, 0xff, 0xff, 0xff, 0xff, 0xff, 0xff, 0xff, 0xff, 0x7f, 0x03, 0x00,
   0x00, 0x00, 0x00, 0x00, 0x00, 0x00, 0x00, 0xc0, 0x01, 0x00, 0x00, 0xfc,
   0xf1, 0x10, 0x00, 0x00, 0x00, 0x80, 0x01, 0x00, 0x00, 0x06, 0x8e, 0xed,
   0x38, 0x00, 0x00, 0x80, 0x01, 0x00, 0x00, 0x04, 0x06, 0x83, 0x67, 0x0f,
   0x00, 0x80, 0x01, 0x00, 0x00, 0x04, 0x00, 0x00, 0xc0, 0x11, 0x00, 0x80,
   0x01, 0x00, 0x00, 0x78, 0x00, 0x00, 0x00, 0x10, 0x00, 0x80, 0x01, 0x00,
   0x00, 0xc0, 0x00, 0x00, 0x00, 0x10, 0x00, 0x80, 0x01, 0x00, 0x00, 0x40,
   0x00, 0x00, 0x00, 0x18, 0x00, 0x80, 0x01, 0x00, 0x00, 0x40, 0x00, 0x00,
   0x80, 0x07, 0x00, 0x80, 0x01, 0x00, 0x00, 0x40, 0x00, 0x00, 0x80, 0x00,
   0x00, 0x80, 0x01, 0x00, 0x00, 0x40, 0x00, 0x00, 0x80, 0x01, 0x00, 0x80,
   0x01, 0x00, 0x00, 0x40, 0x00, 0x00, 0x80, 0x00, 0x00, 0x80, 0x01, 0x00,
   0x00, 0x40, 0x00, 0x00, 0x80, 0x00, 0x00, 0x80, 0x01, 0x00, 0x00, 0x40,
   0x00, 0x00, 0x80, 0x01, 0x00, 0x88, 0x01, 0x00, 0x00, 0x60, 0x00, 0x00,
   0x00, 0x01, 0x00, 0x8d, 0x01, 0x00, 0x00, 0x40, 0x00, 0x00, 0x80, 0x01,
   0x00, 0x9d, 0x01, 0x00, 0x00, 0x20, 0x00, 0x00, 0x00, 0x01, 0x00, 0x97,
   0x01, 0x00, 0x00, 0x20, 0x00, 0x00, 0x80, 0x00, 0x00, 0x82, 0x01, 0x00,
   0x00, 0x20, 0x00, 0x00, 0x00, 0x01, 0x00, 0x80, 0x01, 0x00, 0x00, 0x20,
   0x00, 0x00, 0x80, 0x01, 0x00, 0x80, 0x01, 0x00, 0x00, 0x20, 0x00, 0x00,
   0x00, 0x01, 0x00, 0xbf, 0x01, 0x00, 0x00, 0x20, 0x00, 0x00, 0x00, 0x01,
   0x00, 0x83, 0x01, 0x00, 0x00, 0x20, 0x00, 0x00, 0x00, 0x01, 0x00, 0x82,
   0x01, 0x00, 0x00, 0x20, 0x00, 0x00, 0x00, 0x01, 0x00, 0x86, 0x01, 0x00,
   0x00, 0x30, 0x00, 0x00, 0x00, 0x01, 0x80, 0x87, 0x01, 0x00, 0x00, 0x20,
   0x40, 0x00, 0x80, 0x01, 0x00, 0x83, 0x01, 0x00, 0x00, 0x10, 0xb0, 0xf1,
   0x01, 0x01, 0x00, 0x82, 0x01, 0x00, 0x00, 0x30, 0x18, 0x1a, 0x83, 0x01,
   0x00, 0x8f, 0x01, 0x00, 0x00, 0x1e, 0x0c, 0x0e, 0x02, 0x01, 0x00, 0x8c,
   0x01, 0x00, 0x00, 0x13, 0x04, 0x0e, 0x82, 0x05, 0x00, 0x81, 0x01, 0x00,
   0x80, 0x31, 0x04, 0x04, 0xc2, 0x0b, 0x80, 0x9f, 0x01, 0x00, 0x80, 0xe4,
   0x07, 0x04, 0xfe, 0x08, 0x80, 0x8c, 0x01, 0x00, 0x80, 0x02, 0x04, 0x04,
   0x06, 0x1a, 0x00, 0x89, 0x01, 0x00, 0x40, 0x02, 0x04, 0x0e, 0x02, 0x12,
   0x00, 0x93, 0x01, 0x00, 0xc0, 0x02, 0x0c, 0x0e, 0x02, 0x12, 0x00, 0x96,
   0x01, 0x00, 0x40, 0x00, 0x08, 0x9b, 0x01, 0x12, 0xe0, 0x9f, 0x01, 0x00,
   0x80, 0x00, 0xf0, 0xe1, 0x00, 0x10, 0xb0, 0x98, 0x01, 0x00, 0x80, 0x09,
   0x00, 0x00, 0x00, 0x10, 0x00, 0x91, 0x01, 0x00, 0x00, 0x0f, 0x00, 0x00,
   0x00, 0x18, 0x00, 0xa3, 0x01, 0x00, 0x00, 0x0c, 0x80, 0x11, 0x00, 0x0f,
   0x00, 0xa6, 0x01, 0x00, 0x00, 0x08, 0x60, 0x20, 0x00, 0x05, 0x00, 0xbc,
   0x01, 0x00, 0x00, 0x08, 0x20, 0x60, 0x00, 0x01, 0x00, 0xbf, 0x01, 0x00,
   0x00, 0x0c, 0x10, 0xc0, 0x00, 0x01, 0xc0, 0x83, 0x01, 0x00, 0x00, 0x08,
   0x10, 0x80, 0x00, 0x01, 0x60, 0x82, 0x01, 0x00, 0x00, 0x0c, 0x10, 0x80,
   0x00, 0x01, 0xc0, 0x82, 0x01, 0x00, 0x00, 0x04, 0x10, 0xc0, 0x00, 0x01,
   0x80, 0x83, 0x01, 0x00, 0x00, 0x04, 0x30, 0x40, 0x00, 0x01, 0x00, 0x86,
   0x01, 0x00, 0x00, 0x04, 0x20, 0x40, 0x00, 0x01, 0x00, 0x98, 0x01, 0x00,
   0x00, 0x04, 0xc0, 0x30, 0x00, 0x01, 0x00, 0x80, 0x01, 0x00, 0x00, 0x04,
   0x80, 0x1f, 0x00, 0x01, 0x00, 0x80, 0x01, 0x00, 0x00, 0x04, 0x00, 0x00,
   0x00, 0x01, 0x00, 0x80, 0x01, 0x00, 0x00, 0x04, 0x00, 0x00, 0x00, 0x01,
   0x00, 0x80, 0x01, 0x00, 0x00, 0x06, 0x00, 0x00, 0x00, 0x01, 0x00, 0x88,
   0x01, 0x00, 0x00, 0x06, 0x00, 0x00, 0x00, 0x01, 0x00, 0x80, 0x01, 0x00,
   0x00, 0x02, 0x00, 0x00, 0x00, 0x01, 0x20, 0x87, 0x01, 0x00, 0x00, 0x02,
   0x00, 0x00, 0x00, 0x01, 0xa0, 0x85, 0x01, 0x00, 0x00, 0x02, 0x00, 0x00,
   0x00, 0x01, 0x40, 0x88, 0x01, 0x00, 0x00, 0x02, 0x00, 0x00, 0x00, 0x01,
   0xc0, 0x88, 0x01, 0x00, 0x80, 0x03, 0x00, 0x00, 0x00, 0x01, 0xc0, 0x90,
   0x01, 0x00, 0xc0, 0x06, 0x00, 0x00, 0x00, 0x01, 0x00, 0x90, 0x01, 0x00,
   0x40, 0x1c, 0x00, 0x00, 0x00, 0x01, 0x00, 0x90, 0x01, 0x00, 0x20, 0xf0,
   0x00, 0x00, 0x00, 0x03, 0x00, 0x9c, 0x01, 0x00, 0x20, 0x80, 0x0f, 0x00,
   0x80, 0x07, 0x00, 0x88, 0x01, 0x00, 0xf0, 0x00, 0xf8, 0xd7, 0xff, 0x04,
   0x00, 0x80, 0x01, 0x00, 0x98, 0x03, 0xe0, 0x7f, 0x01, 0x04, 0x00, 0x80,
   0x01, 0x00, 0x08, 0x0c, 0xf0, 0x3f, 0x00, 0x0c, 0x00, 0x80, 0x01, 0x00,
   0x04, 0x30, 0x38, 0x7f, 0x00, 0x0e, 0x00, 0x80, 0x01, 0x00, 0x03, 0xc0,
   0x18, 0xfc, 0x00, 0x13, 0x00, 0x80, 0x01, 0x00, 0x01, 0x80, 0x1f, 0xf0,
   0xc0, 0x61, 0x00, 0x80, 0x01, 0x80, 0x01, 0x00, 0x66, 0xe0, 0x60, 0xc0,
   0x00, 0x80, 0x01, 0xc0, 0x00, 0x00, 0xe0, 0x60, 0x39, 0x80, 0x00, 0x80,
   0x01, 0x60, 0x00, 0x30, 0xc0, 0x3f, 0x0f, 0x00, 0x01, 0x80, 0x01, 0x20,
   0x00, 0x30, 0xc0, 0x0f, 0x00, 0x00, 0x03, 0x80, 0x01, 0x10, 0x00, 0x58,
   0xc0, 0x1f, 0x00, 0x00, 0x02, 0x80, 0x01, 0x18, 0x00, 0xcc, 0xc0, 0x1f,
   0x00, 0x00, 0x06, 0x80, 0x01, 0x0c, 0x00, 0x84, 0xc0, 0x1f, 0x00, 0x00,
   0x0c, 0x80, 0x01, 0x04, 0x04, 0x03, 0xc1, 0x1f, 0x00, 0x00, 0x08, 0x80,
   0x01, 0x06, 0x84, 0x01, 0x62, 0x1f, 0x00, 0x00, 0x18, 0x80, 0x01, 0x02,
   0xc4, 0x00, 0x26, 0x1e, 0x00, 0x60, 0x30, 0x80, 0x01, 0x03, 0x86, 0x00,
   0x27, 0x18, 0x40, 0x40, 0x20, 0x80, 0x81, 0x01, 0x02, 0x81, 0x2f, 0x10,
   0x46, 0x40, 0x40, 0x80, 0x81, 0x00, 0x02, 0xe1, 0x3f, 0x10, 0x66, 0x40,
   0xc0, 0x80, 0x81, 0x00, 0x03, 0xf1, 0x37, 0xd8, 0xff, 0x83, 0xc0, 0x80,
   0xc1, 0x00, 0x01, 0xfb, 0x77, 0x58, 0x00, 0x86, 0x81, 0x80, 0x61, 0x00,
   0x01, 0xff, 0xfb, 0xc9, 0x00, 0x84, 0x81, 0x81, 0x61, 0x80, 0x01, 0xff,
   0xfb, 0x4b, 0x00, 0x04, 0x01, 0x81, 0x81, 0x83, 0x00, 0xfe, 0xff, 0xcf,
   0x00, 0x04, 0x01, 0x81, 0x01, 0xfe, 0x00, 0xfe, 0xff, 0x47, 0x00, 0x0c,
   0xff, 0x81, 0x01, 0xc3, 0x00, 0xfc, 0xff, 0x47, 0x00, 0x08, 0x62, 0x80,
   0x01, 0xc3, 0x00, 0xfc, 0xfd, 0x43, 0x00, 0x0c, 0x42, 0x80, 0x01, 0x41,
   0x00, 0x70, 0xf8, 0xc1, 0x00, 0x08, 0x42, 0x80, 0x81, 0x61, 0x00, 0xe0,
   0x70, 0x80, 0x00, 0x08, 0xc6, 0x80, 0x81, 0x20, 0x00, 0x80, 0x1f, 0x80,
   0x00, 0x08, 0x84, 0x80, 0xc3, 0x20, 0x00, 0x00, 0x00, 0x80, 0x00, 0x08,
   0x84, 0xc0, 0xfe, 0xff, 0xff, 0xff, 0xff, 0xff, 0xff, 0xff, 0xff, 0x7f};
