#define drop_school_width 48
#define drop_school_height 32
static unsigned char drop_school_bits[] = {
   0x00, 0x06, 0x00, 0x00, 0x00, 0x00, 0x00, 0x03, 0x00, 0x00, 0x00, 0x00,
   0x70, 0x01, 0x00, 0x00, 0x00, 0x00, 0xc8, 0x18, 0x00, 0x00, 0x00, 0x00,
   0xc8, 0x0c, 0x00, 0x00, 0x00, 0x00, 0x78, 0x1b, 0x01, 0x00, 0x00, 0x00,
   0xc0, 0xc9, 0x03, 0x00, 0x00, 0x00, 0x00, 0x38, 0xfe, 0x00, 0x00, 0x00,
   0x00, 0x40, 0x91, 0x00, 0x00, 0x00, 0x00, 0x00, 0x88, 0xf0, 0x20, 0x32,
   0x00, 0x00, 0xb8, 0x98, 0x30, 0x1c, 0x00, 0x00, 0xce, 0x8c, 0x9e, 0x70,
   0x00, 0x07, 0x06, 0x84, 0xc9, 0x18, 0x80, 0x04, 0x00, 0x78, 0x48, 0x0c,
   0x80, 0x06, 0x00, 0x00, 0x78, 0x0e, 0x9f, 0x01, 0x00, 0x00, 0x80, 0x4d,
   0xe1, 0x00, 0x00, 0x00, 0x00, 0x38, 0x91, 0x0c, 0x00, 0x00, 0x00, 0x00,
   0xdf, 0x06, 0x0c, 0x60, 0x00, 0x00, 0xe0, 0x01, 0x06, 0x30, 0x00, 0x00,
   0x60, 0xc0, 0x0d, 0x10, 0x00, 0x00, 0x70, 0x38, 0xe6, 0x0c, 0x00, 0x00,
   0x30, 0xe0, 0x1f, 0x0c, 0x00, 0x00, 0x00, 0x00, 0x08, 0x0b, 0x00, 0xc0,
   0x00, 0x00, 0x90, 0xcb, 0x01, 0xe0, 0x00, 0x00, 0x70, 0x29, 0x07, 0x90,
   0x00, 0x00, 0x00, 0x3d, 0x7f, 0x68, 0x00, 0x00, 0x00, 0xc0, 0x48, 0x1c,
   0x00, 0x00, 0x00, 0x00, 0x48, 0x06, 0x00, 0x00, 0x00, 0x00, 0x58, 0x03,
   0x00, 0x00, 0x00, 0x00, 0xb0, 0x02, 0x00, 0x00, 0x00, 0x00, 0x00, 0x1e};
