#define fist_mask_width 96
#define fist_mask_height 64
static unsigned char fist_mask_bits[] = {
   0x00, 0x00, 0x00, 0x00, 0x00, 0x00, 0x00, 0x00, 0x00, 0x00, 0x00, 0x04,
   0x00, 0x00, 0x00, 0x00, 0x00, 0x00, 0x00, 0x00, 0x00, 0x00, 0x80, 0x03,
   0x00, 0x00, 0x00, 0x00, 0x00, 0x00, 0x00, 0x00, 0x00, 0x00, 0xe0, 0x01,
   0x00, 0x00, 0x00, 0x00, 0x00, 0x00, 0xc0, 0x03, 0x00, 0x00, 0xf8, 0x00,
   0x00, 0x00, 0x00, 0x00, 0x00, 0x80, 0xff, 0x07, 0x00, 0x06, 0x7e, 0x00,
   0x00, 0x00, 0x00, 0x00, 0x00, 0xcf, 0xff, 0x07, 0x80, 0xc7, 0x3f, 0x00,
   0xf8, 0xff, 0xff, 0x0f, 0x9c, 0xff, 0xff, 0x0f, 0xfc, 0xff, 0x07, 0x00,
   0xc0, 0xff, 0xff, 0x07, 0xbe, 0xff, 0xff, 0x0f, 0xff, 0xff, 0x03, 0x00,
   0x00, 0xfd, 0xff, 0x01, 0xbe, 0xff, 0xff, 0xcf, 0xff, 0xff, 0x01, 0x00,
   0x00, 0xe0, 0xff, 0x07, 0xfe, 0xff, 0xff, 0xef, 0xff, 0xff, 0x00, 0x00,
   0x00, 0x00, 0xfe, 0xff, 0xfe, 0xff, 0xff, 0x9f, 0xff, 0x79, 0x00, 0x00,
   0x00, 0x00, 0xe0, 0xff, 0xfe, 0xff, 0xff, 0x3f, 0x7e, 0x38, 0x00, 0x00,
   0x00, 0x00, 0xf0, 0xff, 0xfe, 0xff, 0xff, 0xff, 0x1c, 0x18, 0x00, 0x00,
   0x00, 0x00, 0xf8, 0xff, 0xfc, 0xff, 0xff, 0xff, 0x01, 0x08, 0x00, 0x00,
   0x00, 0x00, 0xf8, 0xff, 0xfd, 0xff, 0xff, 0xff, 0x03, 0x00, 0x00, 0x00,
   0x00, 0x00, 0x00, 0xff, 0xfd, 0xff, 0xff, 0xff, 0x03, 0x00, 0x00, 0x00,
   0x00, 0x00, 0x00, 0xf0, 0xf9, 0xff, 0xff, 0xff, 0x07, 0x00, 0x00, 0x00,
   0x00, 0x00, 0x00, 0x00, 0xf8, 0xff, 0xff, 0xff, 0x07, 0x00, 0x00, 0x00,
   0x00, 0x00, 0x00, 0x00, 0xf8, 0xff, 0xff, 0xff, 0x07, 0x00, 0x00, 0x00,
   0x00, 0x00, 0x40, 0x00, 0xf7, 0xff, 0xff, 0xff, 0xe7, 0x3f, 0x00, 0x00,
   0x00, 0x00, 0x70, 0xd0, 0xf7, 0xff, 0xff, 0xff, 0xe7, 0xff, 0x01, 0x00,
   0x00, 0x00, 0x70, 0xf0, 0xef, 0xff, 0xff, 0xff, 0xe7, 0xff, 0x00, 0x00,
   0x00, 0x00, 0x78, 0xfc, 0xef, 0xff, 0xff, 0xff, 0xe7, 0x7f, 0x00, 0x00,
   0x00, 0x00, 0x7c, 0xff, 0xff, 0xff, 0xff, 0xff, 0xe7, 0xff, 0x03, 0x00,
   0x00, 0x00, 0xff, 0xff, 0xef, 0xff, 0xff, 0xff, 0x87, 0xff, 0x3f, 0x00,
   0x00, 0x80, 0xff, 0xff, 0xf3, 0xff, 0xff, 0xff, 0x07, 0xf8, 0xff, 0x03,
   0x00, 0xc0, 0xff, 0xff, 0xfc, 0xff, 0xff, 0xff, 0x07, 0xfc, 0xff, 0x3f,
   0x00, 0xe0, 0x9f, 0x3f, 0xf8, 0xff, 0xff, 0xff, 0x07, 0xfe, 0xff, 0x07,
   0x00, 0xf8, 0x97, 0x1f, 0xf8, 0xff, 0xff, 0xff, 0x87, 0x0f, 0x00, 0x00,
   0x00, 0xfc, 0x81, 0x01, 0xf8, 0xff, 0xff, 0xff, 0x07, 0x00, 0x00, 0x00,
   0x00, 0x7e, 0x00, 0x00, 0xf0, 0xff, 0xff, 0xff, 0x03, 0x00, 0x00, 0x00,
   0x00, 0x0f, 0x00, 0x00, 0xf0, 0xff, 0xff, 0xff, 0x03, 0x00, 0x00, 0x00,
   0xe0, 0x00, 0x00, 0x00, 0xc0, 0xff, 0xff, 0xff, 0x01, 0x00, 0x00, 0x00,
   0x30, 0x00, 0x00, 0x00, 0xc0, 0xff, 0xff, 0x7f, 0x00, 0x00, 0x00, 0x00,
   0x08, 0x00, 0x00, 0x00, 0x80, 0xff, 0xff, 0x1f, 0x00, 0x00, 0x00, 0x00,
   0x00, 0x00, 0x00, 0x00, 0x00, 0xfe, 0xff, 0x0f, 0x00, 0x00, 0x00, 0x00,
   0x00, 0x00, 0x00, 0x00, 0x80, 0xff, 0xff, 0x03, 0x00, 0x00, 0x00, 0x00,
   0x00, 0x00, 0x00, 0x00, 0xc0, 0xff, 0xff, 0x0c, 0x00, 0x00, 0x00, 0x00,
   0x00, 0x00, 0x00, 0x00, 0xc0, 0xff, 0xff, 0x1f, 0x00, 0x00, 0x00, 0x00,
   0x00, 0x00, 0x00, 0x00, 0xc0, 0xff, 0xff, 0x1f, 0x00, 0x00, 0x00, 0x00,
   0x00, 0x00, 0x00, 0x00, 0xc0, 0xff, 0xff, 0x1f, 0x00, 0x00, 0x00, 0x00,
   0x00, 0x00, 0x00, 0x00, 0xc0, 0xff, 0xff, 0x1f, 0x00, 0x00, 0x00, 0x00,
   0x00, 0x00, 0x00, 0x00, 0xc0, 0xff, 0xff, 0x1f, 0x00, 0x00, 0x00, 0x00,
   0x00, 0x00, 0x00, 0x00, 0xc0, 0xff, 0xff, 0x1f, 0x00, 0x00, 0x00, 0x00,
   0x00, 0x00, 0x00, 0x00, 0xc0, 0xff, 0xff, 0x1f, 0x00, 0x00, 0x00, 0x00,
   0x00, 0x00, 0x00, 0x00, 0xc0, 0xff, 0xff, 0x3f, 0x00, 0x00, 0x00, 0x00,
   0x00, 0x00, 0x00, 0x00, 0xc0, 0xff, 0xff, 0x3f, 0x00, 0x00, 0x00, 0x00,
   0x00, 0x00, 0x00, 0x00, 0xc0, 0xff, 0xff, 0x3f, 0x00, 0x00, 0x00, 0x00,
   0x00, 0x00, 0x00, 0x00, 0xc0, 0xff, 0xff, 0x3f, 0x00, 0x00, 0x00, 0x00,
   0x00, 0x00, 0x00, 0x00, 0xc0, 0xff, 0xff, 0x7f, 0x00, 0x00, 0x00, 0x00,
   0x00, 0x00, 0x00, 0x00, 0xc0, 0xff, 0xff, 0x7f, 0x00, 0x00, 0x00, 0x00,
   0x00, 0x00, 0x00, 0x00, 0xc0, 0xff, 0xff, 0x7f, 0x00, 0x00, 0x00, 0x00,
   0x00, 0x00, 0x00, 0x00, 0xc0, 0xff, 0xff, 0x7f, 0x00, 0x00, 0x00, 0x00,
   0x00, 0x00, 0x00, 0x00, 0xc0, 0xff, 0xff, 0x7f, 0x00, 0x00, 0x00, 0x00,
   0x00, 0x00, 0x00, 0x00, 0xc0, 0xff, 0xff, 0xff, 0x00, 0x00, 0x00, 0x00,
   0x00, 0x00, 0x00, 0x00, 0xc0, 0xff, 0xff, 0xff, 0x00, 0x00, 0x00, 0x00,
   0x00, 0x00, 0x00, 0x00, 0xe0, 0xff, 0xff, 0xff, 0x00, 0x00, 0x00, 0x00,
   0x00, 0x00, 0x00, 0x00, 0xe0, 0xff, 0xff, 0xff, 0x00, 0x00, 0x00, 0x00,
   0x00, 0x00, 0x00, 0x00, 0xe0, 0xff, 0xff, 0xff, 0x00, 0x00, 0x00, 0x00,
   0x00, 0x00, 0x00, 0x00, 0xe0, 0xff, 0xff, 0xff, 0x01, 0x00, 0x00, 0x00,
   0x00, 0x00, 0x00, 0x00, 0xe0, 0xff, 0xff, 0xff, 0x01, 0x00, 0x00, 0x00,
   0x00, 0x00, 0x00, 0x00, 0xe0, 0xff, 0xff, 0xff, 0x01, 0x00, 0x00, 0x00,
   0x00, 0x00, 0x00, 0x00, 0xe0, 0xff, 0xff, 0x1f, 0x00, 0x00, 0x00, 0x00,
   0x00, 0x00, 0x00, 0x00, 0x00, 0x00, 0x00, 0x00, 0x00, 0x00, 0x00, 0x00};
