# Map converted by mapmapper
# @(#)$Id: doggy.map,v 3.0 1993/05/21 18:31:45 bjoerns Exp $ Version 1.0
mapWidth:            49
mapHeight:           50
mapName:             DoggyStyle
mapAuthor:           Kjell Irgens
teamPlay:            no
timing:              no
mapData: \multiline: EndOfMapdata
xxxxxxxxxxxxxxxxxxxxxxxxxxxxxxxxxxxxxxxxxxxxxxxxx
x                                               x
x                                               x
x                                               x
x                                               x
x                                               x
x                                               x
x                                               x
x                                               x
x                                               x
x                                               x
x                                               x
x                                               x
x                                               x
x                                               x
x                                               x
x                                               x
x                                               x
x                                               x
x                                               x
x                                               x
x                                               x
x                                               x
x                                               x
x                                               x
x                                               x
x                                               x
x                                               x
x                                               x
x                                               x
x                                               x
x                                               x
x                                               x
x                                               x
x                                               x
x                                               x
x                                               x
x                                               x
x                                               x
x                                               x
x                                               x
x                                               x
x                                               x
x                                               x
x                                               x
x                                               x
x                                               x
x  r   r   r   r   r  r   r   r   r   r   r   r x
x _#_ _#_ _#_ _#_ _# _#_ _#_ _#_ _#_ _#_ _#_ _#_x
xxxxxxxxxxxxxxxxxxxxxxxxxxxxxxxxxxxxxxxxxxxxxxxxx
EndOfMapdata
